NO textures/north.xpm
EA textures/east.xpm
SO textures/south.xpm
WE textures/west.xpm

DOOR_CLOSED textures/bonus/door_closed.xpm
ANIM_3  textures/bonus/anim_3.xpm
ANIM_2          textures/bonus/anim_2.xpm
ANIM_0      textures/bonus/anim_0.xpm
ANIM_1      textures/bonus/anim_1.xpm

C 35,19,73
F 15,6,40

111111111111111111111111111111
100000010010000011111111111111
100000010010010011111111111111
10000001000001100001
100000000010E000001
10000000010000100111
100010000000011001
111111111111111111
111111111111111111
111111111111111111
111111111111111111
111111111111111111
111111111111111111
