NO textures/north.xpm
EA textures/east.xpm
SO textures/south.xpm
WE textures/west.xpm

DOOR_CLOSED textures/bonus/door_closed.xpm
DOOR_OPEN textures/bonus/door_open.xpm
KEY         textures/bonus/key.xpm
ANIM_0      textures/bonus/anim_0.xpm
ANIM_1      textures/bonus/anim_1.xpm

C 35,19,73
F 15,6,40

1111111111111111
1000000100000001
1000000100100001
1000000100000101
100000000010N001
1000000001000001
1000000000000001
1111111111111111

