NO textures/north.xpm
EA textures/east.xpm
SO textures/south.xpm
WE textures/west.xpm

DOOR_CLOSED textures/bonus/door_closed.xpm
ANIM_3      textures/bonus/anim_3.xpm
ANIM_2      textures/bonus/anim_2.xpm
ANIM_0      textures/bonus/anim_0.xpm
ANIM_1      textures/bonus/anim_1.xpm

C 35,19,73
F 15,6,40


1111111111111111111111111
1000110000100000000000001
101D1100000000001111110011111111111111111111111
10DSD100000000001100010000000000000000000000001
101D1000001000000000010000000000000000000000001
11111111111110011111111111111111111111111110001
            1001                          10001
            1001                          10001
            10011111111111111111111111111110001
            10000000000000000000000000000000001
            10000000000000000000000000000000001
            11111111111111111111111111111111111
11111
10001
10011
11111