NO textures/north.xpm
EA textures/east.xpm
SO textures/south.xpm
WE textures/west.xpm

DOOR_CLOSED textures/bonus/door_closed.xpm
ANIM_3      textures/bonus/anim_3.xpm
ANIM_2      textures/bonus/anim_2.xpm
ANIM_0      textures/bonus/anim_0.xpm
ANIM_1      textures/bonus/anim_1.xpm

C 255,255,255
F 0,0,0


11111111111111111111111111111111111111111111111111111111111111111111111111111111111111
11111111111111111111111111111111111111111111111111111111111111111111111111111111111111
 0000000100000100000100000111100000101110101000100000100000100000100000100010100000111
11101000101010101000101000111101010101010101000101000101000100100100100100010101000111
11100000100000100000100000111100000101010101000100000100000100100100100100110100000111
1110100010101010100N101000111101000100000101000101000100010100100100100101010101000111
11101000101000100000100000111101000101010101000100000100000100100100100110010100000111
11101000101010101000101000111101000101010101000101000101000100100100100110010101000111
1110100010100110000010D000111101000101010100000100000100000100100100000110000100000111
1111111111111111111111111111111111111111111111111111111111111111111111111111111111111
1111111111111111111111111111111111111111111111111111111111111111111111111111111111111
10000000000000000000000000000000000000000000000000000000000000000000000000000000000001
