NO textures/north.xpm
EA textures/east.xpm
SO textures/south.xpm
WE textures/west.xpm

DOOR_CLOSED textures/bonus/door_closed.xpm
ANIM_3      textures/bonus/anim_3.xpm
ANIM_2      textures/bonus/anim_2.xpm
ANIM_0      textures/bonus/anim_0.xpm
ANIM_1      textures/bonus/anim_1.xpm

C 35,19,73
F 15,6,40

11111111111111111111
100000010010011011111
1000000100000010001
111D11110000010001
1N000000000000100111
100000000000001001
100000000000000001
111111111111111111
