NO textures/north.xpm
EA textures/east.xpm
SO textures/south.xpm
WE textures/west.xpm

DOOR_CLOSED textures/bonus/door_closed.xpm
ANIM_3      textures/bonus/anim_3.xpm
ANIM_2      textures/bonus/anim_2.xpm
ANIM_0      textures/bonus/anim_0.xpm
ANIM_1      textures/bonus/anim_1.xpm

C 35,19,73
F 15,6,40


1111111111111111111111111
10S0110000100000000000001
1010110000000000111111001
10D0D10000000000110001001
1010100000100000000001001
1111111111111111111111111
