NO textures/north.xpm
EA textures/east.xpm
SO textures/south.xpm
WE textures/west.xpm

DOOR_CLOSED textures/bonus/door_closed.xpm
ANIM_3  textures/bonus/anim_3.xpm
ANIM_2          textures/bonus/anim_2.xpm
ANIM_0      textures/bonus/anim_0.xpm
ANIM_1      textures/bonus/anim_1.xpm

C 35,19,73
F 15,6,40

111111111111111111111111111111111111111
100000000000000000000000000000000000001
101111001111001111000011110000110000001
101000001010001000000010000100110000001
101111001111001111000011110100110000001
101000001010001000000010000010110000001
101000001010001111000010000001111111001
100000000000000000000000000000000000001
10000000000000000W00D000000000000000001
101111000110000100011110000110111100001
101000001010001010010000100101000000001
101111001010001100011110010101111000001
101000001010001010010000001001000000001
101000001111100100011111000101000000001
100000000000000000000000000000000000001
100000000000000000000000000000000000001
101110011100111110000111110000000000001
101010100100100000000100010000000000001
101100100100111100000111100000000000001
101010100100100000000100000000000000001
101010100100111110000100000000000000001
100000000000000000000000000000000000001
111111111111111111111111111111111111111

