F 220,100,0
C 225,30,0

1111111111
1000000001
1011111101
1000000001
100N000001
1111111111
rf
erf
ee
eedf

rff
Ff
Ff
Ff
s
d
